xxxxxxxxxxxxxxxxxxx
x........x........x
x.xx.xxx.x.xxx.xx.x
x....x.......x....x
x.xx.x.xxxxx.x.xx.x
x....x.......x....x
xxxx...xx.xx...xxxx
x....x.x...x.x....x
xxxx.x.xxxxx.x.xxxx
x....x.......x....x
x.xx.x.xxxxx.x.xx.x
x.................x
x.xxx.xx.x.xx.xxx.x
x........x........x
xxxxxxxxxxxxxxxxxxx
